s####### ######;
  ##        ###;
#    ###### ###;
########      #;
#        #### #;
# ###### #### #;
#     ## ###  #;
########   # ##;
############ ##;
   ##         #;
## ##   ##### #;
##         ##  ;
########## ####;
##           ##;
##e######### ##;
